8.ox
o.......
....oo..
.....o.o
........
........
........
........
........